#######
#^@^@##
###.&.#
###&..#
###...#
#######