########
#..^...#
#^@#@&.#
#&.....#
#..#####
 ##