#####
#...#
#^..#
#@..#
#.###
#&&.#
#^..#
#@..#
#####