   ###
  #^^^#
 ##&&&##
#^&@@@&^#
#^&@#@&^#
#^&@@@&^#
 ##&&&##
  #^^^#
   ###