#######
#.@#@^#
#.&#.&#
#.^#..#
#######