 #######
#@@@@...#
#....&&.#
#..^^..#
#&&&&##
#^^^^#
 ####