 #####
#@^&^@#
 #...#
 #&@&#
 #...#
#@^&^@#
 #####